wwwwwwwwwwwwwwww
w              w
w       p      w
w              w
w              w
w              w
w              w
w   s          w
wwwwwwwwwwwwwwww