wwwwwwwww
w   p   w
w       w
w       w
w   s   w
w       w
wwwwwwwww
   