wwwwwwwwwwwwwwww
w  p    w       w
w    w  w       w
w  wwww  w      w
w  w     ww     w  
w            www
wwwwwwwwww     ww
         ww    sw
         wwwwwwww