wwwwwwwwwwwwwwwwwwww
w     p     w      w
w           w      w
w    w      w   s  w
w    w             w
w                  w
wwwwwwwwwwwwwwwwwwww